000000000000000000000
011101111111110111010
010001000000010101010
011111011111111101010
000000010000010001019
011101110111110101010
010101000100000101010
010101011101111101010
010001010001000001010
011111011111011101010
000100000100000101010
011101110111011101110
010001010001010001000
010111010101110111010
010100010100000100010
010101111111111111010
010101000000000000018
011101011101110111110
000001000101010000010
011111111111011111110
000000000000000000000