00000000000000000
01111111111101110
91000000000100012
01011111110111110
01000001000000010
01111111111101110
00000000000101000
01110111011101010
01010101010001010
01011101110101110
01000000000100000
01011111111111010
01010010000101010
01011111010101010
01000001010101010
21111111011101111
00000000008000000