0000000000000000000
9111011101110111110
0001010100010100010
0101010111010111080
0101010101010001000
0111110101110111110
0001000100000010010
0111011101110111010
0100000001010101010
0101110111011101010
0100010100000001010
0111110101110111010
0001000101010100010
0101111101010111010
0101010001000001010
0111011101111111110
0002000200000000000