1111000000900000
0001000000111120
0011111111100000
0001001000000000
0001001111111111
0001000000010000
0001000000010000
0011111111111111
0010100000000001
0020111111111110
0000000000100100
0111111111100111
0800000000000001
0011111111111111