91110000001000000000
00010000001111200000
01111111111000011111
01010010000000000001
01010011111111111111
01010000000100000001
01010000000100000001
01111111111111110011
00101000000000010010
00201111111111181110