000000000000
011101111110
910101000010
000101111010
011110001018
000010101010
011010101010
001010101010
011111111010
000000100010
011111101110
000000000000